0 0 0
0 0 1
0 0 0
0 0 1
0 -1 1
0 -1 0
0 -2 0
0 -3 0
0 -4 0
0 -4 1
-1 -4 1
-1 -5 1
-2 -5 1
-2 -5 2
-2 -6 2
-2 -7 2
-2 -8 2
-2 -9 2
-2 -10 2
-2 -11 2
-3 -11 2
-4 -11 2
-4 -11 1
-4 -11 0
-4 -11 1
-4 -12 1
-4 -12 0
-4 -13 0
-5 -13 0
-5 -14 0
-5 -14 1
-5 -14 2
-5 -14 3
-6 -14 3
-6 -14 2
-6 -14 1
-6 -15 1
-6 -15 0
-6 -16 0
-7 -16 0
-7 -16 -1
-7 -17 -1
-7 -17 0
-7 -17 -1
-7 -17 -2
-7 -18 -2
-8 -18 -2
-9 -18 -2
-9 -18 -3
-9 -18 -2
-9 -18 -1
-9 -19 -1
-10 -19 -1
-10 -19 -2
-10 -20 -2
-11 -20 -2
-11 -21 -2
-11 -22 -2
-12 -22 -2
-12 -22 -3
-13 -22 -3
-13 -22 -2
-14 -22 -2
-15 -22 -2
-15 -22 -1
-16 -22 -1
-17 -22 -1
-17 -23 -1
-18 -23 -1
-18 -23 0
-19 -23 0
-19 -24 0
-19 -25 0
-19 -25 -1
-19 -25 -2
-20 -25 -2
-20 -25 -1
-20 -25 -2
-20 -25 -3
-20 -25 -4
-21 -25 -4
-21 -26 -4
-22 -26 -4
-22 -26 -5
-23 -26 -5
-23 -26 -6
-23 -26 -5
-24 -26 -5
-24 -27 -5
-24 -27 -6
-24 -27 -7
-24 -28 -7
-24 -29 -7
-25 -29 -7
-25 -29 -6
-25 -29 -7
-25 -30 -7
-26 -30 -7
-26 -31 -7
-26 -32 -7
-26 -32 -6
-26 -32 -7
-27 -32 -7
-27 -33 -7
-28 -33 -7
-28 -33 -8
-28 -33 -9
-29 -33 -9
-29 -33 -10
-29 -33 -9
-29 -33 -8
-29 -33 -9
-29 -33 -8
-29 -34 -8
-29 -34 -9
-29 -34 -10
-29 -34 -11
-29 -34 -10
-30 -34 -10
-30 -34 -9
-31 -34 -9
-32 -34 -9
-32 -35 -9
-32 -35 -8
-32 -35 -9
-32 -35 -8
-33 -35 -8
-33 -35 -7
-33 -35 -6
-33 -36 -6
-33 -36 -7
-33 -36 -8
-34 -36 -8
-34 -36 -7
-34 -36 -6
-35 -36 -6
-35 -36 -7
-35 -36 -8
-35 -36 -7
-36 -36 -7
-37 -36 -7
-38 -36 -7
-38 -37 -7
-38 -37 -8
-39 -37 -8
-39 -37 -7
-39 -37 -8
-40 -37 -8
-40 -37 -7
-40 -37 -8
