0 0 0
0 0 -1
1 0 -1
1 -1 -1
1 -2 -1
1 -2 -2
1 -3 -2
1 -4 -2
1 -4 -3
1 -5 -3
2 -5 -3
3 -5 -3
3 -5 -4
3 -5 -5
3 -5 -6
3 -5 -7
4 -5 -7
4 -5 -8
4 -5 -9
5 -5 -9
5 -6 -9
6 -6 -9
6 -7 -9
6 -8 -9
6 -9 -9
6 -10 -9
7 -10 -9
8 -10 -9
8 -10 -10
8 -10 -11
8 -11 -11
8 -12 -11
8 -12 -12
9 -12 -12
9 -12 -13
9 -12 -14
10 -12 -14
10 -13 -14
10 -13 -15
11 -13 -15
12 -13 -15
12 -14 -15
12 -14 -16
12 -14 -17
12 -15 -17
12 -16 -17
12 -17 -17
12 -17 -18
12 -18 -18
13 -18 -18
13 -18 -19
14 -18 -19
14 -19 -19
15 -19 -19
15 -19 -20
15 -20 -20
16 -20 -20
16 -20 -21
17 -20 -21
18 -20 -21
18 -21 -21
18 -22 -21
19 -22 -21
20 -22 -21
20 -23 -21
20 -24 -21
20 -25 -21
20 -26 -21
20 -27 -21
21 -27 -21
21 -28 -21
22 -28 -21
22 -29 -21
23 -29 -21
23 -29 -22
23 -29 -23
24 -29 -23
24 -29 -24
25 -29 -24
25 -29 -25
25 -30 -25
25 -30 -26
25 -30 -27
25 -30 -28
25 -30 -29
25 -30 -30
25 -31 -30
25 -31 -31
25 -31 -32
25 -31 -33
26 -31 -33
26 -32 -33
27 -32 -33
28 -32 -33
29 -32 -33
30 -32 -33
30 -32 -34
31 -32 -34
32 -32 -34
32 -32 -35
32 -32 -36
32 -32 -37
32 -32 -38
32 -33 -38
32 -33 -39
32 -34 -39
32 -34 -40
32 -35 -40
32 -35 -41
33 -35 -41
33 -36 -41
33 -37 -41
33 -37 -42
33 -38 -42
34 -38 -42
34 -38 -43
35 -38 -43
35 -39 -43
36 -39 -43
36 -39 -44
36 -40 -44
36 -41 -44
36 -42 -44
36 -43 -44
36 -44 -44
36 -45 -44
36 -46 -44
36 -47 -44
36 -48 -44
36 -49 -44
37 -49 -44
38 -49 -44
39 -49 -44
40 -49 -44
41 -49 -44
41 -50 -44
41 -51 -44
41 -52 -44
41 -53 -44
41 -54 -44
41 -55 -44
42 -55 -44
42 -55 -45
43 -55 -45
43 -56 -45
43 -56 -46
43 -57 -46
44 -57 -46
45 -57 -46
45 -57 -47
