0 0 0
0 -1 0
0 -1 -1
0 -2 -1
-1 -2 -1
-1 -2 -2
-2 -2 -2
-3 -2 -2
-4 -2 -2
-4 -3 -2
-3 -3 -2
-4 -3 -2
-3 -3 -2
-3 -4 -2
-4 -4 -2
-5 -4 -2
-6 -4 -2
-7 -4 -2
-8 -4 -2
-9 -4 -2
-8 -4 -2
-7 -4 -2
-7 -4 -3
-7 -4 -4
-7 -5 -4
-8 -5 -4
-8 -5 -5
-9 -5 -5
-8 -5 -5
-9 -5 -5
-9 -6 -5
-9 -7 -5
-9 -8 -5
-8 -8 -5
-8 -8 -6
-8 -8 -7
-9 -8 -7
-9 -8 -8
-10 -8 -8
-9 -8 -8
-9 -8 -9
-10 -8 -9
-10 -9 -9
-10 -9 -10
-10 -9 -11
-11 -9 -11
-10 -9 -11
-9 -9 -11
-9 -9 -12
-9 -10 -12
-9 -11 -12
-10 -11 -12
-9 -11 -12
-9 -11 -13
-10 -11 -13
-9 -11 -13
-10 -11 -13
-11 -11 -13
-10 -11 -13
-10 -11 -14
-9 -11 -14
-9 -12 -14
-8 -12 -14
-7 -12 -14
-7 -13 -14
-6 -13 -14
-5 -13 -14
-6 -13 -14
-5 -13 -14
-5 -14 -14
-4 -14 -14
-5 -14 -14
-6 -14 -14
-6 -14 -15
-6 -14 -16
-5 -14 -16
-5 -15 -16
-5 -15 -17
-5 -15 -18
-5 -15 -19
-4 -15 -19
-5 -15 -19
-4 -15 -19
-4 -15 -20
-3 -15 -20
-3 -15 -21
-3 -16 -21
-2 -16 -21
-3 -16 -21
-3 -16 -22
-3 -16 -23
-4 -16 -23
-5 -16 -23
-4 -16 -23
-4 -17 -23
-4 -17 -24
-5 -17 -24
-4 -17 -24
-5 -17 -24
-6 -17 -24
-6 -18 -24
-6 -18 -25
-5 -18 -25
-6 -18 -25
-5 -18 -25
-5 -18 -26
-5 -18 -27
-4 -18 -27
-4 -18 -28
-4 -19 -28
-4 -20 -28
-4 -20 -29
-4 -21 -29
-5 -21 -29
-5 -21 -30
-5 -21 -31
-5 -21 -32
-5 -22 -32
-4 -22 -32
-4 -23 -32
-3 -23 -32
-2 -23 -32
-3 -23 -32
-3 -24 -32
-3 -24 -33
-3 -25 -33
-2 -25 -33
-2 -26 -33
-2 -27 -33
-3 -27 -33
-3 -27 -34
-3 -27 -35
-2 -27 -35
-2 -28 -35
-2 -29 -35
-1 -29 -35
-1 -29 -36
-1 -29 -37
-1 -30 -37
0 -30 -37
1 -30 -37
2 -30 -37
1 -30 -37
1 -30 -38
2 -30 -38
2 -31 -38
2 -31 -39
3 -31 -39
3 -32 -39
3 -32 -40
