0 0 0
0 1 0
0 0 0
0 0 1
-1 0 1
-1 0 0
-2 0 0
-3 0 0
-3 0 -1
-3 0 0
-2 0 0
-2 -1 0
-2 0 0
-2 1 0
-2 1 -1
-2 1 -2
-2 0 -2
-2 0 -3
-2 0 -4
-2 -1 -4
-2 -1 -3
-1 -1 -3
-2 -1 -3
-3 -1 -3
-3 -1 -2
-4 -1 -2
-4 -2 -2
-4 -3 -2
-4 -2 -2
-4 -2 -3
-4 -2 -2
-4 -2 -1
-4 -1 -1
-3 -1 -1
-3 -1 -2
-3 -1 -3
-3 -2 -3
-4 -2 -3
-4 -2 -4
-3 -2 -4
-3 -3 -4
-4 -3 -4
-4 -2 -4
-4 -2 -5
-5 -2 -5
-6 -2 -5
-6 -2 -4
-6 -1 -4
-7 -1 -4
-6 -1 -4
-6 0 -4
-6 -1 -4
-6 -1 -3
-6 -2 -3
-6 -2 -4
-6 -2 -3
-6 -3 -3
-6 -3 -4
-5 -3 -4
-5 -4 -4
-5 -4 -3
-5 -4 -2
-4 -4 -2
-3 -4 -2
-3 -4 -1
-3 -4 0
-3 -4 1
-4 -4 1
-4 -4 2
-3 -4 2
-3 -4 3
-3 -5 3
-4 -5 3
-4 -6 3
-4 -6 2
-4 -5 2
-3 -5 2
-3 -5 1
-3 -6 1
-3 -6 0
-3 -6 1
-3 -6 0
-3 -5 0
-3 -5 -1
-3 -4 -1
-3 -4 -2
-3 -4 -1
-3 -3 -1
-3 -3 -2
-3 -3 -3
-3 -4 -3
-4 -4 -3
-4 -5 -3
-3 -5 -3
-2 -5 -3
-2 -6 -3
-2 -6 -4
-1 -6 -4
-1 -7 -4
-1 -7 -5
-1 -6 -5
-1 -6 -6
-1 -5 -6
-2 -5 -6
-2 -4 -6
-3 -4 -6
-3 -4 -7
-3 -4 -6
-3 -4 -7
-2 -4 -7
-2 -4 -6
-3 -4 -6
-3 -3 -6
-4 -3 -6
-4 -4 -6
-4 -4 -7
-4 -5 -7
-4 -5 -6
-3 -5 -6
-3 -4 -6
-3 -4 -5
-3 -4 -4
-4 -4 -4
-4 -4 -3
-5 -4 -3
-5 -4 -2
-5 -4 -1
-5 -4 0
-5 -4 1
-6 -4 1
-6 -5 1
-6 -6 1
-5 -6 1
-4 -6 1
-3 -6 1
-3 -6 2
-4 -6 2
-5 -6 2
-5 -6 3
-5 -6 4
-5 -6 5
-4 -6 5
-4 -6 4
-4 -7 4
-4 -7 5
-4 -6 5
-5 -6 5
-4 -6 5
-3 -6 5
-3 -6 4
